             NO             path/NORTH     
   EA             NORTH


     SO     SOU     TH       
 WE     WE   ST










F     250.100.2



C     255.4.5









11111111111                
111011111111111
111111111110001011       S    1
111111111111111111111111111   