             NO             path/NORTH     
   EA             NORTH


     SO     SOU     TH       
 WE     WE   ST








F     250.100.2



C     255.4.5





11111111111                
1E11011111111111
111111111110001011            1
11111111111111111        