             NO             path/NORTH     
   EA             NORTH


     SO     SOU     TH       
 WE     WE   ST











F     255.4.5
C     255.4.5











111111111111
101010100011
110000000011
10E000010011
100000001111
101000000011
111111111111