NO             path/NORTH     
EA             NORTH


SO     SOU     TH       
WE     WE   ST











F     171.197.242
C    212.204.181











11111111111
10000000001
1000000101
101000000111111111111111
101010000000000000100011
101010000111110000101011
101010001111100000101011
101010000000000111111111
101010001111100000000011
101010001111100000101011
101010000111110000101011
101010000000000000101011
101010000111110000101011
101010000000000000010001
101010000011111101111101
101010000011111100000001
10101S000011111111111101
101010000000000000000001
101010000011111101111101
101010000011111100000001
101010000011111111111101
101010000000000000000001
111111111111111111111111