NO             path/NORTH     
EA             NORTH


SO     SOU     TH       
WE     WE   ST











F     171.197.242
C    212.204.181











11111111111
10000000001
101E0000101
10100000011
10101000001
11111111111