             NO             path/NORTH     
   EA             NORTH


     SO     SOU     TH       
 WE     WE   ST











F     255.4.5
C     255.4.5











11111111111
100000000011
10100100000011
10100100000011
101000N000011
1010000000001
1010000011111
11100011111
11111111111