NO             path/NORTH     
EA             NORTH


SO     SOU     TH       
WE     WE   ST











F     255.4.5
C    255.4.5











11111111111
10000000001
101E0000101
10100000011
10101000001
11111111111