   NO             NORTH
   EA             NORTH


     SO     SOU     TH       
 WE     WE   ST









F     FLOOR             



C     CIELING     




11111111111     
1E11011111111111
111111111110001011
111111111111111111
