F    171,197,242
C    212,204 ,0

NO              ./textures/1a.xpm
EA              ./textures/1b.xpm
SO              textures/1c.xpm



WE              textures/1d.xpm
         
                            11111111                    
                            101N1001        
                            10000E01                     
                            10000001     
                            11111111    
