NO              textures/11.xpm
EA             textures/1b.xpm


SO     textures/1c.xpm
WE     textures/1d.xpm











F     171,197,242
C    212,204,181











11111111111
10000000001
1000000101
101000000111111111111111
101010000000000000100011
101010000111110000101011
101010001111100000101011
101010000000000111111111
101010001111100000000011
101010001111100000101011
101010000111110000101011
101010000000000000101011
101010000111110000101011
101010000000000000010001
101010000011111101111101
1010010000111111000000011
10101S1000101010101010101
1010010000000000000000011
101011000011111101111101
101010000011111100000001
101010000011111111111101
101010000000000000000001
111111111111111111111111