



F 15,110,100
C    212,204,10

NO              ./textures/1a.xpm
EA              ./textures/1b.xpm
SO ./textures/1c.xpm



WE              ./textures/1d.xpm   

11111111111111111111
11000000000000001111
110010111N1110011111
11001001110000111111
11011100000110011111
1100000000000011111
11111111111111111111