F    5,15,100
C    212,204,181

NO              ./textures/1a.xpm
EA              ./textures/1b.xpm
SO              textures/1c.xpm



WE              textures/1d.xpm
                11111111                    
                10010001        
                101N1001
                10010001        
                11111111    
