NO              textures/1a.xpm
EA              textures/1b.xpm
C 0,204,204
F 51,102,0
SO              textures/1c.xpm
WE              textures/1d.xpm



                1111111111111
                11000S0000011
                111110011111
                111110011111
                111110011111
                111110011111
                1100000000011
                1111111111111
